SumoBot	KEYWORD1
getDistance	KEYWORD2
DistanceSensor	KEYWORD1
distance	KEYWORD2
anRead	KEYWORD2
digRead	KEYWORD2
setCoeficiente	KEYWORD2
getCoeficiente	KEYWORD2
setExponente	KEYWORD2
getExponente	KEYWORD2
LightSensor	KEYWORD1
black	KEYWORD2
Motor	KEYWORD1
forward	KEYWORD2
backward	KEYWORD2
stop	KEYWORD2
Led	KEYWORD1
red	KEYWORD2
blue	KEYWORD2
green	KEYWORD2
off	KEYWORD2